Script started on 2019-11-14 15:15:46-05:00 [TERM="xterm-256color" TTY="/dev/pts/10" COLUMNS="80" LINES="24"]
qxiong1@remote00:~/i220b/work/lab13$ cd[K[Kls
file-char-count  file-copy  lab13.log  no-buffer-copy  rec-io  stdin-char-count
qxiong1@remote00:~/i220b/work/lab13$ cd stdin-char-count/
qxiong1@remote00:~/i220b/work/lab13/stdin-char-count$ ls
Makefile  stdin-char-count  stdin-char-count.c
qxiong1@remote00:~/i220b/work/lab13/stdin-char-count$ cd ..
qxiong1@remote00:~/i220b/work/lab13$ cd file-c[Kca[Khar-count/
qxiong1@remote00:~/i220b/work/lab13/file-char-count$ vim F[Kfile-char-count.c 
[?1000h[?2004h[?1049h[22;0;0t[?1h=[?2004h[1;24r[?12h[?12l[22;2t[22;1t[27m[23m[29m[m[H[2J[?25l[24;1H"file-char-count.c" 27L, 566C[2;1H▽[6n[2;1H  [1;1H[>c]10;?]11;?[1;1H[35m#include [m[31m<errno.h>[m
[35m#include [m[31m<stdio.h>[m
[35m#include [m[31m<stdlib.h>[m
[35m#include [m[31m<string.h>[m

[34m/** Output number of chars in file specified by single command-line
 *  argument.
 */[m
[32mint[m
main([32mint[m argc, [32mconst[m [32mchar[m *argv[])
{
  [38;5;130mif[m (argc != [31m2[m) {
    fprintf([31mstderr[m, [31m"usage: [m[35m%s[m[31m FILE_NAME[m[35m\n[m[31m"[m, argv[[31m0[m]);
    exit([31m1[m);
  }
  [32mconst[m [32mchar[m *fName = argv[[31m1[m];
  [32mFILE[m *in = fopen(fName, [31m"r"[m);
  [38;5;130mif[m (!in) {
    fprintf([31mstderr[m, [31m"cannot read [m[35m%s[m[31m: [m[35m%s\n[m[31m"[m, fName, strerror(errno));
    exit([31m1[m);
  }
  [32mint[m c;
  [32mint[m count = [31m0[m;[24;63H1,1[11CTop[1;1H[?25hP+q436f\P+q6b75\P+q6b64\P+q6b72\P+q6b6c\P+q2332\P+q2334\P+q2569\P+q2a37\P+q6b31\[?1000l[?1006h[?1002h[?1006l[?1002l[?1006h[?1002h[27m[23m[29m[m[H[2J[?25l[1;1H[38;5;81m#include [m[95m<errno.h>[m
[38;5;81m#include [m[95m<stdio.h>[m
[38;5;81m#include [m[95m<stdlib.h>[m
[38;5;81m#include [m[95m<string.h>[m

[96m/** Output number of chars in file specified by single command-line
 *  argument.
 */[m
[38;5;121mint[m
main([38;5;121mint[m argc, [38;5;121mconst[m [38;5;121mchar[m *argv[])
{
  [93mif[m (argc != [95m2[m) {
    fprintf([95mstderr[m, [95m"usage: [m[38;5;224m%s[m[95m FILE_NAME[m[38;5;224m\n[m[95m"[m, argv[[95m0[m]);
    exit([95m1[m);
  }
  [38;5;121mconst[m [38;5;121mchar[m *fName = argv[[95m1[m];
  [38;5;121mFILE[m *in = fopen(fName, [95m"r"[m);
  [93mif[m (!in) {
    fprintf([95mstderr[m, [95m"cannot read [m[38;5;224m%s[m[95m: [m[38;5;224m%s\n[m[95m"[m, fName, strerror(errno));
    exit([95m1[m);
  }
  [38;5;121mint[m c;
  [38;5;121mint[m count = [95m0[m;[24;63H1,1[11CTop"file-char-count.c" 27L, 566C[1;1H[?25h[?25l[1;23r[1;1H[4M[1;24r[20;3H[93mwhile[m ((c = fgetc(in)) != [95mEOF[m) count++;
  printf([95m"[m[38;5;224m%d\n[m[95m"[m, count);
  [93mreturn[m [95m0[m;
}[24;1H[K[24;63H22,8[10CBot[18;8H[?25h[?25l[24;53H4[21;15H[18;8H[48;5;242m; 
  [m[38;5;121m[48;5;242mint[m[48;5;242m count = [m[95m[48;5;242m0[m[48;5;242m; 
  [m[93m[48;5;242mwhile[m[48;5;242m ((c = fgetc(in)) != [m[95m[48;5;242mEOF[m[48;5;242m) count++; 
  printf([m[95m[48;5;242m"[m[38;5;224m[48;5;242m%d\n[m


[1m-- VISUAL --[m[24;53H[K[24;53H4[21;15H[24;63H25,15[9CBot[21;15H[?25h[?25l[24;53H3[20;16Hgetc(in)) != [95mEOF[m) count++;[20;42H[K[21;1H  printf([95m"[m[38;5;224m%d\n[m[24;64H4,16[20;16H[?25h[?25l[?25h[?25l[24;53H [22;11H[18;8H;[18;9H[K[19;1H  [38;5;121mint[m count = [95m0[m;[19;17H[K[20;1H  [93mwhile[m ((c = f[24;1H[K[24;63H26,11[9CBot[22;11H[?25h[?25l[24;63H13,37[9;37H[?25h[?25l[24;64H6,3 [12;3H[?25h[?25l[24;53H2[12;4H[38;5;121m[48;5;242mc[m[24;1H[1m-- VISUAL --[m[24;53H[K[24;53H2[12;4H[24;63H16,4[10CBot[12;4H[?25h[?25l[24;53H3[12;5H[38;5;121m[48;5;242mo[m[24;66H5[12;5H[?25h[?25l[24;53H4[12;6H[38;5;121m[48;5;242mn[m[24;66H6[12;6H[?25h[?25l[24;53H5[12;7H[38;5;121m[48;5;242ms[m[24;66H7[12;7H[?25h[?25l[24;53H6[12;8H[38;5;121m[48;5;242mt[m[24;66H8[12;8H[?25h[?25l[24;53H7[12;9H[48;5;242m [m[24;66H9[12;9H[?25h[?25l[24;53H8[12;10H[38;5;121m[48;5;242mc[m[24;66H10[12;10H[?25h[?25l[24;53H9[12;11H[38;5;121m[48;5;242mh[m[24;67H1[12;11H[?25h[?25l[24;53H10[12;12H[38;5;121m[48;5;242ma[m[24;67H2[12;12H[?25h[?25l[24;54H1[12;13H[38;5;121m[48;5;242mr[m[24;67H3[12;13H[?25h[?25l[24;54H2[12;14H[48;5;242m [m[24;67H4[12;14H[?25h[?25l[24;54H3[12;15H[48;5;242m*[m[24;67H5[12;15H[?25h[?25l[24;54H4[12;16H[48;5;242mf[m[24;67H6[12;16H[?25h[?25l[24;54H5[12;17H[48;5;242mN[m[24;67H7[12;17H[?25h[?25l[24;54H6[12;18H[48;5;242ma[m[24;67H8[12;18H[?25h[?25l[24;54H7[12;19H[48;5;242mm[m[24;67H9[12;19H[?25h[?25l[24;54H8[12;20H[48;5;242me[m[24;66H20[12;20H[?25h[?25l[24;54H9[12;21H[48;5;242m [m[24;67H1[12;21H[?25h[?25l[24;53H2 [11;4H
[48;5;242m  [m[1C[38;5;121monst[m [38;5;121mchar[m *fName [24;64H5,4 [11;4H[?25h[?25l[?25h[?25l[?25h[?25l[?25h[?25l[?25h[?25l[?25h[?25l[?25h[?25l[24;54H6[12;28H  [1C[38;5;121m[48;5;242monst[m[48;5;242m [m[38;5;121m[48;5;242mchar[m[48;5;242m *fName = argv[[m[24;64H6,28[12;28H[?25h[?25l[24;54H7[12;29H[95m[48;5;242m1[m[46m][m[24;67H9[12;29H[?25h[?25l[24;54H8[12;30H[48;5;242m][m[24;66H30[12;30H[?25h[?25l[24;54H9[12;31H[48;5;242m;[m[24;67H1[12;31H[?25h[?25l[?25h[?25l[24;54H [13;32H[12;31H[48;5;242m 
  [m[38;5;121m[48;5;242mFILE[m[48;5;242m *in = fopen(fName, [m[95m[48;5;242m"r"[m[48;5;242m);[m[24;64H7,32[13;32H[?25h[?25l[?25h[?25l[?25h[?25l[24;53H3[14;13H[13;32H[48;5;242m 
  [m[93m[48;5;242mif[m[48;5;242m (!in) {[m[24;64H8,13[14;13H[?25h[?25l[?25h[?25l[?25h[?25l[24;53H4[15;36H[14;13H[48;5;242m 
    fprintf([m[95m[48;5;242mstderr[m[48;5;242m, [m[95m[48;5;242m"cannot read [m[38;5;224m[48;5;242m%s[m[24;64H9,36[15;36H[?25h[?25l[1C[95m[48;5;242m:[m[24;67H7[15;37H[?25h[?25l[1C[95m[48;5;242m [m[24;67H8[15;38H[?25h[?25l[24;53H5[16;13H[15;38H[38;5;224m[48;5;242m%s\n[m[95m[48;5;242m"[m[48;5;242m, fName, strerror(errno)); 
    exit([m[95m[48;5;242m1[m[48;5;242m);[m[24;63H20,13[16;13H[?25h[?25l[?25h[?25l[?25h[?25l[24;53H6[17;4H[16;13H[48;5;242m 
  }[m[24;64H1,4 [17;4H[?25h[?25l[?25h[?25l[?25h[?25l[24;53H [17;3H[12;3H[38;5;121mconst[m [38;5;121mchar[m *fName = argv[[95m1[m];[12;31H[K[13;1H  [38;5;121mFILE[m *in = fopen(fName, [95m"r"[m);[13;32H[K[14;1H  [93mif[m (!in) [46m{[m[14;13H[K[15;1H    fprintf([95mstderr[m, [95m"cannot read [m[38;5;224m%s[m[95m: [m[38;5;224m%s\n[m[95m"[m, fName, strerror(errno));[15;69H[K[16;1H    exit([95m1[m);[16;13H[K[17;1H  [46m}[m[24;1H[K[24;63H21,3[10CBot[17;3H[?25h[?25l[14;12H{[17;3H}[24;64H2[18;3H[?25h[?25l[24;53H2[18;4H[38;5;121m[48;5;242mi[m[24;1H[1m-- VISUAL --[m[24;53H[K[24;53H2[18;4H[24;63H22,4[10CBot[18;4H[?25h[?25l[24;53H3[18;5H[38;5;121m[48;5;242mn[m[24;66H5[18;5H[?25h[?25l[24;53H2[19;5H[18;5H[38;5;121m[48;5;242mt[m[48;5;242m c; 
  [m[38;5;121m[48;5;242min[m[24;64H3[19;5H[?25h[?25l[2C[38;5;121m[48;5;242mt[m[48;5;242m [m[24;66H7[19;7H[?25h[?25lc[48;5;242mc[m[24;66H8[19;8H[?25h[?25lo[48;5;242mo[m[24;66H9[19;9H[?25h[?25lu[48;5;242mu[m[24;66H10[19;10H[?25h[?25ln[48;5;242mn[m[24;67H1[19;11H[?25h[?25l[24;53H3[20;12H[19;11H[48;5;242mt = [m[95m[48;5;242m0[m[48;5;242m; 
  [m[93m[48;5;242mwhile[m[48;5;242m ((c[m[24;64H4,12[20;12H[?25h[?25l [48;5;242m [m[24;67H3[20;13H[?25h[?25l= [48;5;242m= [m[24;67H5[20;15H[?25h[?25lfg[48;5;242mfg[m[24;67H7[20;17H[?25h[?25l[24;53H4[21;18H[20;17H[48;5;242metc(in)) != [m[95m[48;5;242mEOF[m[48;5;242m) count++; 
  printf([m[95m[48;5;242m"[m[38;5;224m[48;5;242m%d\n[m[95m[48;5;242m"[m[48;5;242m, [m[24;64H5,18[21;18H[?25h[?25lc[48;5;242mc[m[24;67H9[21;19H[?25h[?25lo[48;5;242mo[m[24;66H20[21;20H[?25h[?25lun[48;5;242mun[m[24;67H2[21;22H[?25h[?25l[24;53H5[22;12H[21;22H[48;5;242mt); 
  [m[93m[48;5;242mreturn[m[48;5;242m [m[95m[48;5;242m0[m[48;5;242m;[m[24;64H6,1[22;12H[?25h[?25l[?25h[?25l[24;53H6[23;2H[22;12H[48;5;242m 
}[m[24;64H7,2 [23;2H[?25h[?25l[?25h[?25l[?25h[?25l[?25h[?25l[22;2H[1;23r[23;1H
[1;24r[23;1H[94m~                                                                               [m[24;53H[K[24;53H6[22;2H[24;63H27,2[10CBot[22;2H[?25h[?25l[?25h[?25l[24;53H [21;11H[17;3H[38;5;121mint[m c;[17;9H[K[18;1H  [38;5;121mint[m count = [95m0[m;[18;17H[K[19;1H  [93mwhile[m ((c = fgetc(in)) != [95mEOF[m) count++;[19;42H[K[20;1H  printf([95m"[m[38;5;224m%d\n[m[95m"[m, count);[20;25H[K[21;1H  [93mreturn[m [95m0[m;[21;12H[K[22;1H}[24;1H[K[24;63H26,11[9CBot[21;11H[?25h[?25l[24;63H19,29[14;29H[?25h[?25l[24;53H2[13;13H
[48;5;242m    fprintf([m[95m[48;5;242mstderr[m[48;5;242m, [m[95m[48;5;242m"cannot r[m[24;1H[1m-- VISUAL --[m[24;53H[K[24;53H2[13;13H[24;63H18,13[9CBot[13;13H[?25h[?25l[24;53H3[12;28H[1C[95m[48;5;242m"[m[48;5;242m); 
  [m[93m[48;5;242mif[m[48;5;242m (!in) { [m[24;64H7,28[12;28H[?25h[?25l[24;53H4[11;27H[46m[[m[95m[48;5;242m1[m[48;5;242m]; 
  [m[38;5;121m[48;5;242mFILE[m[48;5;242m *in = fopen(fName, [m[95m[48;5;242m"r[m[24;64H6,27[11;27H[?25h[?25l[24;53H5[10;4H
[48;5;242m  [m[38;5;121m[48;5;242mconst[m[48;5;242m [m[38;5;121m[48;5;242mchar[m[48;5;242m *fName = argv[[m[24;64H5,4 [10;4H[?25h[?25l[?25h[?25l[24;53H6[9;13H
[48;5;242m  } [m[24;64H4,13[9;13H[?25h[?25l[24;53H7[8;26H[1C[95m[48;5;242m: [m[38;5;224m[48;5;242m%s[m[95m[48;5;242m FILE_NAME[m[38;5;224m[48;5;242m\n[m[95m[48;5;242m"[m[48;5;242m, argv[[m[95m[48;5;242m0[m[48;5;242m]); 
    exit([m[95m[48;5;242m1[m[48;5;242m); [m[24;64H3,26[8;26H[?25h[?25l[1C[95m[48;5;242me[m[24;67H5[8;25H[?25h[?25l[24;53H8[7;19H
[48;5;242m    fprintf([m[95m[48;5;242mstderr[m[48;5;242m, [m[95m[48;5;242m"usag[m[24;64H2,19[7;19H[?25h[?25l[24;53H9[6;2H
[48;5;242m  [m[93m[48;5;242mif[m[48;5;242m (argc != [m[95m[48;5;242m2[m[48;5;242m) { [m[24;64H1,2 [6;2H[?25h[?25l[24;53H10[5;24H[1C[38;5;121m[48;5;242mr[m[48;5;242m *argv[]) 
{ [m[24;64H0,24[5;24H[?25h[?25l[24;54H1[4;4H
[48;5;242mmain([m[38;5;121m[48;5;242mint[m[48;5;242m argc, [m[38;5;121m[48;5;242mconst[m[48;5;242m [m[38;5;121m[48;5;242mcha[m[24;63H9,4  [4;4H[?25h[?25l[24;54H2[3;4H
[38;5;121m[48;5;242mint[m[48;5;242m [m[24;63H8[3;4H[?25h[?25l[?25h[?25l[24;54H3[2;14H
[96m[48;5;242m */[m[48;5;242m [m[24;63H7,14[2;14H[?25h[?25l[24;54H4[2;23H[1;23r[1;1H[L[1;24r[2;24H[96m[48;5;242mars in file specified by single command-line[m[48;5;242m [m
[96m[48;5;242m *  argument.[m[48;5;242m [m[24;53H[K[24;53H14[2;23H[24;63H6,23[10CBot[2;23H[?25h[?25l[24;54H5[2;1H[1;23r[1;1H[L[1;24r[1;1H[38;5;81m#include [m[95m<string.h>[m

[96m[48;5;242m/** Output number of ch[m[24;53H[K[24;53H15[2;1H[24;63H5,0-1[9C75%[2;1H[?25h[?25l[24;54H6[2;20H[1;23r[1;1H[L[1;24r[1;1H[38;5;81m#include [m[95m<stdlib.h>[m

[48;5;242m [m[24;53H[K[24;53H16[2;20H[24;63H4,20[10C50%[2;20H[?25h[?25l[?25h[?25l[24;54H4[4;21H[3;1H[K[4;1H[96m/** Output number of [m[24;63H6,21[4;21H[?25h[?25l[24;54H2[6;4H[4;22H[96mchars in file specified by single command-line[m[4;68H[K[5;1H[96m *  argument.[m[5;14H[K[6;1H[96m */[m[6;4H[K[24;63H8,4 [6;4H[?25h[?25l[24;54H1[7;4H[38;5;121mint[m[7;4H[K[24;63H9[7;4H[?25h[?25l[24;54H0[8;22Hmain([38;5;121mint[m argc, [38;5;121mconst[m [38;5;121mc[m[24;63H10,22[8;22H[?25h[?25l[24;53H8 [10;19H[8;23H[38;5;121mhar[m *argv[])[8;35H[K[9;1H{[9;2H[K[10;1H  [93mif[m (argc != [95m2[m) {[10;19H[K[24;64H2,19[10;19H[?25h[?25l[24;53H7[11;22H    fprintf([95mstderr[m, [95m"u[m[24;64H3,22[11;22H[?25h[?25l[24;53H6[12;13H[11;23H[95msage: [m[38;5;224m%s[m[95m FILE_NAME[m[38;5;224m\n[m[95m"[m, argv[[95m0[m]);[11;55H[K[12;1H    exit([95m1[m);[12;13H[K[24;64H4,13[12;13H[?25h[?25l[24;53H4[14;23H[13;1H  }[13;4H[K[14;1H  [38;5;121mconst[m [38;5;121mchar[m *fName = a[24;64H6,2[14;23H[?25h[?25l[24;53H3[15;23H[14;24Hrgv[[95m1[m];[14;31H[K[15;1H  [38;5;121mFILE[m *in = fopen(fNam[24;64H7[15;23H[?25h[?25lme[24;67H4[15;24H[?25h[?25l[24;53H2[16;13H[15;25H, [95m"r"[m);[15;32H[K[16;1H  [93mif[m (!in) {[16;13H[K[24;64H8,13[16;13H[?25h[?25l[24;53H6[17;24H    fprintf([95mstderr[m, [95m"can[m[24;64H9,24[17;24H[?25h[?25l[24;53H5[17;25H[95mn[m[24;67H5[17;25H[?25h[?25l[24;53H2[18;13H[17;26H[95mot [m[1C[95m[48;5;242mead [m[38;5;224m[48;5;242m%s[m[95m[48;5;242m: [m[38;5;224m[48;5;242m%s\n[m[95m[48;5;242m"[m[48;5;242m, fName, strerror(errno)); 
    exit([m[95m[48;5;242m1[m[48;5;242m);[m[24;63H20,13[18;13H[?25h[?25l[24;53H3[19;4H[18;13H[48;5;242m 
  }[m[24;64H1,4 [19;4H[?25h[?25l[?25h[?25l[24;53H4[20;9H[19;4H[48;5;242m 
  [m[38;5;121m[48;5;242mint[m[48;5;242m c;[m[24;64H2,9[20;9H[?25h[?25l[24;53H5[21;17H[20;9H[48;5;242m 
  [m[38;5;121m[48;5;242mint[m[48;5;242m count = [m[95m[48;5;242m0[m[48;5;242m;[m[24;64H3,17[21;17H[?25h[?25l[?25h[?25l[24;53H6[22;27H[21;17H[48;5;242m 
  [m[93m[48;5;242mwhile[m[48;5;242m ((c = fgetc(in)) ![m[24;64H4,2[22;27H[?25h[?25l[24;53H7[23;25H[22;27H[48;5;242m= [m[95m[48;5;242mEOF[m[48;5;242m) count++; 
  printf([m[95m[48;5;242m"[m[38;5;224m[48;5;242m%d\n[m[95m[48;5;242m"[m[48;5;242m, count);[m[24;64H5,25[23;25H[?25h[?25l[24;53H8[23;12H[1;23r[23;1H
[1;24r[22;25H[48;5;242m 
  [m[93m[48;5;242mreturn[m[48;5;242m [m[95m[48;5;242m0[m[48;5;242m;[m[24;53H[K[24;53H8[23;12H[24;63H26,12[9C75%[23;12H[?25h[?25l[24;53H9[23;2H[1;23r[23;1H
[1;24r[22;12H[48;5;242m 
}[m[24;53H[K[24;53H9[23;2H[24;63H27,2[10CBot[23;2H[?25h[?25l[22;2H[1;23r[23;1H
[1;24r[23;1H[94m~                                                                               [m[24;53H[K[24;53H9[22;2H[24;63H27,2[10CBot[22;2H[?25h[?25l[?25h[?25l[?25h[?25l[24;53H7[20;25H[20;25H[K[21;1H  [93mreturn[m [95m0[m;[21;12H[K[22;1H}[24;64H5,25[20;25H[?25h[?25l[24;53H6[19;28H [95mEOF[m) count++;[19;42H[K[20;1H  printf([95m"[m[38;5;224m%d\n[m[95m"[m, count);[24;64H4,28[19;28H[?25h[?25l[24;53H5[18;17H[18;17H[K[19;1H  [93mwhile[m ((c = fgetc(in)) !=[24;64H3,17[18;17H[?25h[?25l[24;53H2[15;13H[15;13H[K[16;1H  }[16;4H[K[17;1H  [38;5;121mint[m c;[17;9H[K[18;1H  [38;5;121mint[m count = [95m0[m;[24;64H0,13[15;13H[?25h[?25l[24;53H5[14;25H[1C[95m[48;5;242mot [m[1C[95mead [m[38;5;224m%s[m[95m: [m[38;5;224m%s\n[m[95m"[m, fName, strerror(errno));[14;69H[K[15;1H    exit([95m1[m);[24;63H19,25[14;25H[?25h[?25l[24;53H2[13;13H
[48;5;242m    fprintf([m[95m[48;5;242mstderr[m[48;5;242m, [m[95m[48;5;242m"cann[m[24;64H8,13[13;13H[?25h[?25l[24;53H3[12;25H,[48;5;242m [m[95m[48;5;242m"r"[m[48;5;242m); 
  [m[93m[48;5;242mif[m[48;5;242m (!in) { [m[24;64H7,25[12;25H[?25h[?25l[24;53H4[11;25Hg[48;5;242mv[[m[95m[48;5;242m1[m[48;5;242m]; 
  [m[38;5;121m[48;5;242mFILE[m[48;5;242m *in = fopen(fName,[m[24;64H6[11;25H[?25h[?25lr[48;5;242mg[m[24;67H4[11;24H[?25h[?25l[24;53H5[10;4H
[48;5;242m  [m[38;5;121m[48;5;242mconst[m[48;5;242m [m[38;5;121m[48;5;242mchar[m[48;5;242m *fName = ar[m[24;64H5,4 [10;4H[?25h[?25l[24;53H6[9;13H
[48;5;242m  } [m[24;64H4,13[9;13H[?25h[?25l[24;53H7[8;23H[1C[95m[48;5;242mage: [m[38;5;224m[48;5;242m%s[m[95m[48;5;242m FILE_NAME[m[38;5;224m[48;5;242m\n[m[95m[48;5;242m"[m[48;5;242m, argv[[m[95m[48;5;242m0[m[48;5;242m]); 
    exit([m[95m[48;5;242m1[m[48;5;242m); [m[24;64H3,2[8;23H[?25h[?25l[24;53H8[7;19H
[48;5;242m    fprintf([m[95m[48;5;242mstderr[m[48;5;242m, [m[95m[48;5;242m"us[m[24;64H2,19[7;19H[?25h[?25l[24;53H9[6;2H
[48;5;242m  [m[93m[48;5;242mif[m[48;5;242m (argc != [m[95m[48;5;242m2[m[48;5;242m) { [m[24;64H1,2 [6;2H[?25h[?25l[?25h[?25l[24;53H10[5;22H[1C[38;5;121m[48;5;242mhar[m[48;5;242m *argv[]) 
{ [m[24;64H0,22[5;22H[?25h[?25l[24;54H1[4;4H
[48;5;242mmain([m[38;5;121m[48;5;242mint[m[48;5;242m argc, [m[38;5;121m[48;5;242mconst[m[48;5;242m [m[38;5;121m[48;5;242mc[m[24;63H9,4  [4;4H[?25h[?25l[24;54H2[3;4H
[38;5;121m[48;5;242mint[m[48;5;242m [m[24;63H8[3;4H[?25h[?25l[24;54H3[2;14H
[96m[48;5;242m */[m[48;5;242m [m[24;63H7,14[2;14H[?25h[?25l[24;54H4[2;21H[1;23r[1;1H[L[1;24r[2;22H[96m[48;5;242mchars in file specified by single command-line[m[48;5;242m [m
[96m[48;5;242m *  argument.[m[48;5;242m [m[24;53H[K[24;53H14[2;21H[24;63H6,21[10CBot[2;21H[?25h[?25l[?25h[?25l[24;53H  [6;3H[1;23r[1;1H[L[1;24r[1;1H[38;5;81m#include [m[95m<string.h>[m[3;22H[96mchars in file specified by single command-line[m[3;68H[K[4;1H[96m *  argument.[m[4;14H[K[5;1H[96m */[m[5;4H[K[6;1H[38;5;121mint[m[6;4H[K[7;1Hmain([38;5;121mint[m argc, [38;5;121mconst[m [38;5;121mchar[m *argv[])[7;35H[K[8;1H{[8;2H[K[9;1H  [93mif[m (argc != [95m2[m) {[9;19H[K[10;1H    fprintf([95mstderr[m, [95m"usage: [m[38;5;224m%s[m[95m FILE_NAME[m[38;5;224m\n[m[95m"[m, argv[[95m0[m]);[10;55H[K[11;1H    exit([95m1[m);[11;13H[K[12;1H  }[12;4H[K[13;1H  [38;5;121mconst[m [38;5;121mchar[m *fName = argv[[95m1[m];[13;31H[K[14;1H  [38;5;121mFILE[m *in = fopen(fName, [95m"r"[m);[14;32H[K[15;1H  [93mif[m (!in) {[15;13H[K[16;1H    fprintf([95mstderr[m, [95m"cannot r[m[24;1H[K[24;63H9,3[11C75%[6;3H[?25h[?25l[24;53H^[[6;3H[24;53H  [6;3H[24;53H^[[6;3H[24;53H  [6;3H[?25h[?25l[24;53H:[6;3H[24;53H[K[24;1H:[?2004h[?25hq[?25l[?25h[?25l[?1006l[?1002l[?2004l[23;2t[23;1t[22;2t[22;1t[23;2t[23;1t[24;1H[K[24;1H[?2004l[?1l>[?25h[?1049l[23;0;0tqxiong1@remote00:~/i220b/work/lab13/file-char-count$ ls
file-char-count.c  Makefile
qxiong1@remote00:~/i220b/work/lab13/file-char-count$ lsvim file-char-count.c 
[?1000h[?2004h[?1049h[22;0;0t[?1h=[?2004h[1;24r[?12h[?12l[22;2t[22;1t[27m[23m[29m[m[H[2J[?25l[24;1H"file-char-count.c" 27L, 566C[2;1H▽[6n[2;1H  [1;1H[>c]10;?]11;?[1;1H[35m#include [m[31m<errno.h>[m
[35m#include [m[31m<stdio.h>[m
[35m#include [m[31m<stdlib.h>[m
[35m#include [m[31m<string.h>[m

[34m/** Output number of chars in file specified by single command-line
 *  argument.
 */[m
[32mint[m
main([32mint[m argc, [32mconst[m [32mchar[m *argv[])
{
  [38;5;130mif[m (argc != [31m2[m) {
    fprintf([31mstderr[m, [31m"usage: [m[35m%s[m[31m FILE_NAME[m[35m\n[m[31m"[m, argv[[31m0[m]);
    exit([31m1[m);
  }
  [32mconst[m [32mchar[m *fName = argv[[31m1[m];
  [32mFILE[m *in = fopen(fName, [31m"r"[m);
  [38;5;130mif[m (!in) {
    fprintf([31mstderr[m, [31m"cannot read [m[35m%s[m[31m: [m[35m%s\n[m[31m"[m, fName, strerror(errno));
    exit([31m1[m);
  }
  [32mint[m c;
  [32mint[m count = [31m0[m;[24;63H9,3[11CTop[9;3H[?25hP+q436f\P+q6b75\P+q6b64\P+q6b72\P+q6b6c\P+q2332\P+q2334\P+q2569\P+q2a37\P+q6b31\[?1000l[?1006h[?1002h[?1006l[?1002l[?1006h[?1002h[27m[23m[29m[m[H[2J[?25l[1;1H[38;5;81m#include [m[95m<errno.h>[m
[38;5;81m#include [m[95m<stdio.h>[m
[38;5;81m#include [m[95m<stdlib.h>[m
[38;5;81m#include [m[95m<string.h>[m

[96m/** Output number of chars in file specified by single command-line
 *  argument.
 */[m
[38;5;121mint[m
main([38;5;121mint[m argc, [38;5;121mconst[m [38;5;121mchar[m *argv[])
{
  [93mif[m (argc != [95m2[m) {
    fprintf([95mstderr[m, [95m"usage: [m[38;5;224m%s[m[95m FILE_NAME[m[38;5;224m\n[m[95m"[m, argv[[95m0[m]);
    exit([95m1[m);
  }
  [38;5;121mconst[m [38;5;121mchar[m *fName = argv[[95m1[m];
  [38;5;121mFILE[m *in = fopen(fName, [95m"r"[m);
  [93mif[m (!in) {
    fprintf([95mstderr[m, [95m"cannot read [m[38;5;224m%s[m[95m: [m[38;5;224m%s\n[m[95m"[m, fName, strerror(errno));
    exit([95m1[m);
  }
  [38;5;121mint[m c;
  [38;5;121mint[m count = [95m0[m;[24;63H9,3[11CTop"file-char-count.c" 27L, 566C[9;3H[?25h[?25l[12;18H[46m{[15;3H}[m[24;63H12,18[12;18H[?25h[?25l[24;53H2[13;27H[12;18H[48;5;242m{ 
    fprintf([m[95m[48;5;242mstderr[m[48;5;242m, [m[95m[48;5;242m"usage[m

  }[24;1H[1m-- VISUAL --[m[24;13H[K[24;53H2[13;27H[24;63H13,27[9CTop[13;27H[?25h[?25l[24;53H3[14;13H[13;27H[95m[48;5;242m: [m[38;5;224m[48;5;242m%s[m[95m[48;5;242m FILE_NAME[m[38;5;224m[48;5;242m\n[m[95m[48;5;242m"[m[48;5;242m, argv[[m[95m[48;5;242m0[m[48;5;242m]); 
    exit([m[95m[48;5;242m1[m[48;5;242m);[m[24;64H4,13[14;13H[?25h[?25l[?25h[?25l[24;53H4[15;4H[14;13H[48;5;242m 
  }[m[24;64H5,4 [15;4H[?25h[?25l[?25h[?25l[24;53H5[16;29H[15;4H[48;5;242m 
  [m[38;5;121m[48;5;242mconst[m[48;5;242m [m[38;5;121m[48;5;242mchar[m[48;5;242m *fName = argv[[m[95m[48;5;242m1[m[46m][m[24;64H6,29[16;29H[?25h[?25l[1C[48;5;242m][m[24;66H30[16;30H[?25h[?25l[24;53H6[17;30H[16;30H[48;5;242m; 
  [m[38;5;121m[48;5;242mFILE[m[48;5;242m *in = fopen(fName, [m[95m[48;5;242m"r"[m[46m)[m[24;64H7[17;30H[?25h[?25l[24;53H7[18;13H[17;30H[48;5;242m); 
  [m[93m[48;5;242mif[m[48;5;242m (!in) {[m[24;64H8,13[18;13H[?25h[?25l[24;53H8[19;32H[18;13H[48;5;242m 
    fprintf([m[95m[48;5;242mstderr[m[48;5;242m, [m[95m[48;5;242m"cannot rea[m[24;64H9,32[19;32H[?25h[?25l[24;53H9[20;13H[19;32H[95m[48;5;242md [m[38;5;224m[48;5;242m%s[m[95m[48;5;242m: [m[38;5;224m[48;5;242m%s\n[m[95m[48;5;242m"[m[48;5;242m, fName, strerror(errno)); 
    exit([m[95m[48;5;242m1[m[48;5;242m);[m[24;63H20,13[20;13H[?25h[?25l[?25h[?25l[24;53H10[21;4H[20;13H[48;5;242m 
  }[m[24;64H1,4 [21;4H[?25h[?25l[?25h[?25l[24;54H1[22;9H[21;4H[48;5;242m 
  [m[38;5;121m[48;5;242mint[m[48;5;242m c;[m[24;64H2,9[22;9H[?25h[?25l[?25h[?25l[24;54H2[23;17H[22;9H[48;5;242m 
  [m[38;5;121m[48;5;242mint[m[48;5;242m count = [m[95m[48;5;242m0[m[48;5;242m;[m[24;64H3,17[23;17H[?25h[?25l[?25h[?25l[24;54H3[23;37H[1;23r[23;1H
[1;24r[22;17H[48;5;242m 
  [m[93m[48;5;242mwhile[m[48;5;242m ((c = fgetc(in)) != [m[95m[48;5;242mEOF[m[48;5;242m) cou[mnt++;[24;53H[K[24;53H13[23;37H[24;63H24,37[9C25%[23;37H[?25h[?25l[24;54H4[23;25H[1;23r[23;1H
[1;24r[22;37H[48;5;242mnt++; 
  printf([m[95m[48;5;242m"[m[38;5;224m[48;5;242m%d\n[m[95m[48;5;242m"[m[48;5;242m, count);[m[24;53H[K[24;53H14[23;25H[24;63H25,25[9C50%[23;25H[?25h[?25l[24;54H5[23;12H[1;23r[23;1H
[1;24r[22;25H[48;5;242m 
  [m[93m[48;5;242mreturn[m[48;5;242m [m[95m[48;5;242m0[m[48;5;242m;[m[24;53H[K[24;53H15[23;12H[24;63H26,12[9C75%[23;12H[?25h[?25l[24;54H6[23;2H[1;23r[23;1H
[1;24r[22;12H[48;5;242m 
}[m[24;53H[K[24;53H16[23;2H[24;63H27,2[10CBot[23;2H[?25h[?25l[22;2H[1;23r[23;1H
[1;24r[23;1H[94m~                                                                               [m[24;53H[K[24;53H16[22;2H[24;63H27,2[10CBot[22;2H[?25h[?25l[?25h[?25l[24;53H  [19;16H[7;18H{[7;19H[K[8;1H    fprintf([95mstderr[m, [95m"usage: [m[38;5;224m%s[m[95m FILE_NAME[m[38;5;224m\n[m[95m"[m, argv[[95m0[m]);[8;55H[K[9;1H    exit([95m1[m);[9;13H[K[10;1H  }[10;4H[K[11;1H  [38;5;121mconst[m [38;5;121mchar[m *fName = argv[[95m1[m];[11;31H[K[12;1H  [38;5;121mFILE[m *in = fopen(fName, [95m"r"[m);[12;32H[K[13;1H  [93mif[m (!in) {[13;13H[K[14;1H    fprintf([95mstderr[m, [95m"cannot read [m[38;5;224m%s[m[95m: [m[38;5;224m%s\n[m[95m"[m, fName, strerror(errno));[14;69H[K[15;1H    exit([95m1[m);[15;13H[K[16;1H  }[16;4H[K[17;1H  [38;5;121mint[m c;[17;9H[K[18;1H  [38;5;121mint[m count = [95m0[m;[18;17H[K[19;1H  [93mwhile[m ((c = fgetc(in)) != [95mEOF[m) count++;[19;42H[K[20;1H  printf([95m"[m[38;5;224m%d\n[m[95m"[m, count);[20;25H[K[21;1H  [93mreturn[m [95m0[m;[21;12H[K[22;1H}[24;1H[K[24;63H24,16[9CBot[19;16H[?25h[?25l[24;53H^F[19;16H[24;53H  [6;1H[1;23r[1;1H[16M[1;24r[8;1H[94m~                                                                               [9;1H~                                                                               [10;1H~                                                                               [11;1H~                                                                               [12;1H~                                                                               [13;1H~                                                                               [14;1H~                                                                               [15;1H~                                                                               [16;1H~                                                                               [17;1H~                                                                               [18;1H~                                                                               [19;1H~                                                                               [20;1H~                                                                               [21;1H~                                                                               [22;1H~                                                                               [23;1H~                                                                               [m[24;63H[K[24;63H27,1[10CBot[6;1H[?25h[?25l[7;1H[K[24;64H8,0-1[7;1H[?25h[?25l[1;23r[1;1H[3L[1;24r[1;5Hfprintf([95mstderr[m, [95m"cannot read [m[38;5;224m%s[m[95m: [m[38;5;224m%s\n[m[95m"[m, fName, strerror(errno));
    exit([95m1[m);
  }[24;63H[K[24;63H28,0-1[8CBot[10;1H[?25h[?25l[24;64H5,24 [7;24H[?25h[?25l[24;53H2[6;42H
[48;5;242m  printf([m[95m[48;5;242m"[m[38;5;224m[48;5;242m%d\n[m[95m[48;5;242m"[m[48;5;242m, count);[m[24;1H[1m-- VISUAL --[m[24;53H[K[24;53H2[6;42H[24;63H24,42[9CBot[6;42H[?25h[?25l[24;53H3[5;17H
[48;5;242m  [m[93m[48;5;242mwhile[m[48;5;242m ((c = fgetc(in)) != [m[95m[48;5;242mEOF[m[48;5;242m) count++; [m[24;64H3,17[5;17H[?25h[?25l[?25h[?25l[24;53H4[4;9H
[48;5;242m  [m[38;5;121m[48;5;242mint[m[48;5;242m count = [m[95m[48;5;242m0[m[48;5;242m; [m[24;64H2,9 [4;9H[?25h[?25l[24;53H5[3;4H
[48;5;242m  [m[38;5;121m[48;5;242mint[m[48;5;242m c; [m[24;64H1,4[3;4H[?25h[?25l[24;53H6[2;13H
[48;5;242m  } [m[24;64H0,13[2;13H[?25h[?25l[?25h[?25l[24;53H7[2;38H[1;23r[1;1H[L[1;24r[1;3H[93mif[m (!in) {[2;39H[38;5;224m[48;5;242ms\n[m[95m[48;5;242m"[m[48;5;242m, fName, strerror(errno)); 
    exit([m[95m[48;5;242m1[m[48;5;242m); [m[24;53H[K[24;53H7[2;38H[24;63H19,38[9CBot[2;38H[?25h[?25l[24;53H8[2;13H[1;23r[1;1H[L[1;24r[1;3H[38;5;121mFILE[m *in = fopen(fName, [95m"r"[m);

[48;5;242m    fprintf([m[95m[48;5;242mstderr[m[48;5;242m, [m[95m[48;5;242m"cannot read [m[38;5;224m[48;5;242m%s[m[95m[48;5;242m: [m[38;5;224m[48;5;242m%[m[24;53H[K[24;53H8[2;13H[24;63H18,13[9CBot[2;13H[?25h[?25l[24;53H9[2;32H[1;23r[1;1H[L[1;24r[1;3H[38;5;121mconst[m [38;5;121mchar[m *fName = argv[[95m1[m];

[48;5;242m  [m[93m[48;5;242mif[m[48;5;242m (!in) { [m[24;53H[K[24;53H9[2;32H[24;63H17,32[9CBot[2;32H[?25h[?25l[24;53H10[2;31H[1;23r[1;1H[L[1;24r[1;3H}

[48;5;242m  [m[38;5;121m[48;5;242mFILE[m[48;5;242m *in = fopen(fName, [m[95m[48;5;242m"r"[m[48;5;242m); [m[24;53H[K[24;53H10[2;31H[24;63H16,31[9CBot[2;31H[?25h[?25l[24;54H1[2;4H[1;23r[1;1H[L[1;24r[1;5Hexit([95m1[m);

[48;5;242m  [m[38;5;121m[48;5;242mconst[m[48;5;242m [m[38;5;121m[48;5;242mchar[m[48;5;242m *fName = argv[[m[95m[48;5;242m1[m[48;5;242m]; [m[24;53H[K[24;53H11[2;4H[24;63H15,4[10CBot[2;4H[?25h[?25l[24;54H2[2;13H[1;23r[1;1H[L[1;24r[1;5Hfprintf([95mstderr[m, [95m"usage: [m[38;5;224m%s[m[95m FILE_NAME[m[38;5;224m\n[m[95m"[m, argv[[95m0[m]);

[48;5;242m  } [m[24;53H[K[24;53H12[2;13H[24;63H14,13[9CBot[2;13H[?25h[?25l[?25h[?25l[?25h[?25l[24;53H  [13;24H[3;1H  }[3;4H[K[4;1H  [38;5;121mconst[m [38;5;121mchar[m *fName = argv[[95m1[m];[4;31H[K[5;1H  [38;5;121mFILE[m *in = fopen(fName, [95m"r"[m);[5;32H[K[6;1H  [93mif[m (!in) {[6;13H[K[7;1H    fprintf([95mstderr[m, [95m"cannot read [m[38;5;224m%s[m[95m: [m[38;5;224m%s\n[m[95m"[m, fName, strerror(errno));[7;69H[K[8;1H    exit([95m1[m);[8;13H[K[9;1H  }[9;4H[K[10;1H  [38;5;121mint[m c;[10;9H[K[11;1H  [38;5;121mint[m count = [95m0[m;[11;17H[K[12;1H  [93mwhile[m ((c = fgetc(in)) != [95mEOF[m) count++;[12;42H[K[13;1H  printf([95m"[m[38;5;224m%d\n[m[95m"[m, count);[24;1H[K[24;63H25,24[9CBot[13;24H[?25h[?25l[24;64H0,12[8;12H[?25h[?25l[24;53H2[7;51H [48;5;242mstrerror(errno)); 
    exit([m[95m[48;5;242m1[m[48;5;242m);[m[24;1H[1m-- VISUAL --[m[24;53H[K[24;53H2[7;51H[24;63H19,51[9CBot[7;51H[?25h[?25l[24;53H3[6;13H
[48;5;242m    fprintf([m[95m[48;5;242mstderr[m[48;5;242m, [m[95m[48;5;242m"cannot read [m[38;5;224m[48;5;242m%s[m[95m[48;5;242m: [m[38;5;224m[48;5;242m%s\n[m[95m[48;5;242m"[m[48;5;242m, fName, [m[24;64H8,13[6;13H[?25h[?25l[24;53H5[4;31H
[48;5;242m  [m[38;5;121m[48;5;242mFILE[m[48;5;242m *in = fopen(fName, [m[95m[48;5;242m"r"[m[48;5;242m); 
  [m[93m[48;5;242mif[m[48;5;242m (!in) { [m[24;64H6,31[4;31H[?25h[?25l[24;53H6[3;4H
[48;5;242m  [m[38;5;121m[48;5;242mconst[m[48;5;242m [m[38;5;121m[48;5;242mchar[m[48;5;242m *fName = argv[[m[95m[48;5;242m1[m[48;5;242m]; [m[24;64H5,4 [3;4H[?25h[?25l[24;53H7[2;13H
[48;5;242m  } [m[24;64H4,13[2;13H[?25h[?25l[?25h[?25l[24;53H8[2;49H[1;23r[1;1H[L[1;24r[1;3H[93mif[m (argc != [95m2[m) {[2;50H[48;5;242m[[m[95m[48;5;242m0[m[48;5;242m]); 
    exit([m[95m[48;5;242m1[m[48;5;242m); [m[24;53H[K[24;53H8[2;49H[24;63H13,49[9CBot[2;49H[?25h[?25l[24;53H9[2;19H[1;23r[1;1H[L[1;24r[1;1H{

[48;5;242m    fprintf([m[95m[48;5;242mstderr[m[48;5;242m, [m[95m[48;5;242m"usage: [m[38;5;224m[48;5;242m%s[m[95m[48;5;242m FILE_NAME[m[38;5;224m[48;5;242m\n[m[95m[48;5;242m"[m[48;5;242m, argv[m[24;53H[K[24;53H9[2;19H[24;63H12,19[9CBot[2;19H[?25h[?25l[24;53H10[2;2H[1;23r[1;1H[L[1;24r[1;1Hmain([38;5;121mint[m argc, [38;5;121mconst[m [38;5;121mchar[m *argv[])

[48;5;242m  [m[93m[48;5;242mif[m[48;5;242m (argc != [m[95m[48;5;242m2[m[48;5;242m) { [m[24;53H[K[24;53H10[2;2H[24;63H11,2[10CBot[2;2H[?25h[?25l[24;54H1[2;35H[1;23r[1;1H[L[1;24r[1;1H[38;5;121mint[m

[48;5;242m{ [m[24;53H[K[24;53H11[2;35H[24;63H10,35[9CBot[2;35H[?25h[?25l[24;54H2[2;4H[1;23r[1;1H[L[1;24r[1;1H[96m */[m

[48;5;242mmain([m[38;5;121m[48;5;242mint[m[48;5;242m argc, [m[38;5;121m[48;5;242mconst[m[48;5;242m [m[38;5;121m[48;5;242mchar[m[48;5;242m *argv[]) [m[24;53H[K[24;53H12[2;4H[24;63H9,4[11CBot[2;4H[?25h[?25l[24;54H3[2;4H[1;23r[1;1H[L[1;24r[1;1H[96m *  argument.[m

[38;5;121m[48;5;242mint[m[48;5;242m [m[24;53H[K[24;53H13[2;4H[24;63H8,4[11CBot[2;4H[?25h[?25l[?25h[?25l[24;53H  [6;5H[3;1H[38;5;121mint[m[3;4H[K[4;1Hmain([38;5;121mint[m argc, [38;5;121mconst[m [38;5;121mchar[m *argv[])[4;35H[K[5;1H{[5;2H[K[6;1H  [93mif[m (argc != [95m2[m) {[6;19H[K[7;1H    fprintf([95mstderr[m, [95m"usage: [m[38;5;224m%s[m[95m FILE_NAME[m[38;5;224m\n[m[95m"[m, argv[[95m0[m]);[7;55H[K[8;1H    exit([95m1[m);[8;13H[K[9;1H  }[9;4H[K[10;1H  [38;5;121mconst[m [38;5;121mchar[m *fName = argv[[95m1[m];[10;31H[K[11;1H  [38;5;121mFILE[m *in = fopen(fName, [95m"r"[m);[11;32H[K[12;1H  [93mif[m (!in) {[12;13H[K[13;1H    fprintf([95mstderr[m, [95m"cannot read [m[38;5;224m%s[m[95m: [m[38;5;224m%s\n[m[95m"[m, fName, strerror(errno));[13;69H[K[14;1H    exit([95m1[m);[24;1H[K[24;63H12,5[10CBot[6;5H[?25h[?25l[24;64H6,9[10;9H[?25h[?25l[24;53H2[10;10H[38;5;121m[48;5;242mc[m[24;1H[1m-- VISUAL --[m[24;53H[K[24;53H2[10;10H[24;63H16,10[9CBot[10;10H[?25h[?25l[24;53H3[10;11H[38;5;121m[48;5;242mh[m[24;67H1[10;11H[?25h[?25l[24;53H4[10;12H[38;5;121m[48;5;242ma[m[24;67H2[10;12H[?25h[?25l[24;53H5[10;13H[38;5;121m[48;5;242mr[m[24;67H3[10;13H[?25h[?25l[24;53H6[10;14H[48;5;242m [m[24;67H4[10;14H[?25h[?25l[24;53H7[10;15H[48;5;242m*[m[24;67H5[10;15H[?25h[?25l[24;53H8[10;16H[48;5;242mf[m[24;67H6[10;16H[?25h[?25l[24;53H9[10;17H[48;5;242mN[m[24;67H7[10;17H[?25h[?25l[24;53H10[10;18H[48;5;242ma[m[24;67H8[10;18H[?25h[?25l[24;54H1[10;19H[48;5;242mm[m[24;67H9[10;19H[?25h[?25l[24;54H2[10;20H[48;5;242me[m[24;66H20[10;20H[?25h[?25l[24;54H3[10;21H[48;5;242m [m[24;67H1[10;21H[?25h[?25l[24;54H4[10;22H[48;5;242m=[m[24;67H2[10;22H[?25h[?25l[24;54H5[10;23H[48;5;242m [m[24;67H3[10;23H[?25h[?25l[24;54H6[10;24H[48;5;242ma[m[24;67H4[10;24H[?25h[?25l[24;54H7[10;25H[48;5;242mr[m[24;67H5[10;25H[?25h[?25l[24;54H8[10;26H[48;5;242mg[m[24;67H6[10;26H[?25h[?25l[?25h[?25l[24;53H  [11;1H[10;9H[38;5;121mchar[m *fName = arg[24;1H[K[24;63H17,1[10CBot[11;1H[?25h[?25l[24;53H2[11;2H[48;5;242m [m[24;1H[1m-- VISUAL --[m[24;53H[K[24;53H2[11;2H[24;63H17,2[10CBot[11;2H[?25h[?25l[24;53H3[11;3H[48;5;242m [m[24;66H3[11;3H[?25h[?25l[24;53H4[11;4H[38;5;121m[48;5;242mF[m[24;66H4[11;4H[?25h[?25l[24;53H6[11;6H[38;5;121m[48;5;242mIL[m[24;66H6[11;6H[?25h[?25l[24;53H7[11;7H[38;5;121m[48;5;242mE[m[24;66H7[11;7H[?25h[?25l[24;53H9[11;9H[48;5;242m *[m[24;66H9[11;9H[?25h[?25l[24;53H10[11;10H[48;5;242mi[m[24;66H10[11;10H[?25h[?25l[24;54H2[11;12H[48;5;242mn [m[24;67H2[11;12H[?25h[?25l[24;54H4[11;14H[48;5;242m= [m[24;67H4[11;14H[?25h[?25l[24;54H5[11;15H[48;5;242mf[m[24;67H5[11;15H[?25h[?25l[24;54H8[11;18H[48;5;242mope[m[24;67H8[11;18H[?25h[?25l[24;54H9[11;19H[48;5;242mn[m[46m([10C)[m[24;67H9[11;19H[?25h[?25l[24;53H21[11;21H[48;5;242m(f[m[9C)[24;66H21[11;21H[?25h[?25l[24;54H2[11;22H[48;5;242mN[m[24;67H2[11;22H[?25h[?25l[24;54H3[11;23H[48;5;242ma[m[24;67H3[11;23H[?25h[?25l[24;54H5[11;25H[48;5;242mme[m[24;67H5[11;25H[?25h[?25l[24;54H6[11;26H[48;5;242m,[m[24;67H6[11;26H[?25h[?25l[24;54H7[11;27H[48;5;242m [m[24;67H7[11;27H[?25h[?25l[24;54H8[11;28H[95m[48;5;242m"[m[24;67H8[11;28H[?25h[?25l[24;54H9[11;29H[95m[48;5;242mr[m[24;67H9[11;29H[?25h[?25l[24;53H30[11;30H[95m[48;5;242m"[m[46m)[m[24;66H30[11;30H[?25h[?25l[24;54H1[11;31H[48;5;242m)[m[24;67H1[11;31H[?25h[?25l[24;54H2[11;32H[48;5;242m;[m[24;67H2[11;32H[?25h[?25l[?25h[?25l[?25h[?25l[?25h[?25l[?25h[?25l[?25h[?25l[24;53H^[[11;32H[24;53H32[11;32H[24;55H^[[11;32H[24;53H    [11;31H  [38;5;121mFILE[m *in = fopen(fName, [95m"r"[m);[24;1H[K[24;63H17,31[9CBot[11;31H[?25h[?25l[24;53H:[11;31H[24;53H[K[24;1H:[?2004h[?25hq[?25l[?25h[?25l[97m[41mE37: No write since last change (add ! to override)[?2004h[11;31H[m[24;63H17,31[9CBot[11;31H[?25h[?25l[24;53H:[11;31H[24;1H[K[24;1H:[?2004h[?25hq[?25l[?25h![?25l[?25h[?25l[?1006l[?1002l[?2004l[23;2t[23;1t[22;2t[22;1t[23;2t[23;1t[24;1H[K[24;1H[?2004l[?1l>[?25h[?1049l[23;0;0tqxiong1@remote00:~/i220b/work/lab13/file-char-count$ make
gcc -g -Wall -std=c11    file-char-count.c   -o file-char-count
qxiong1@remote00:~/i220b/work/lab13/file-char-count$ ./file-char-count  [Kfile-char-count.c 
566
qxiong1@remote00:~/i220b/work/lab13/file-char-count$ wc

^C
qxiong1@remote00:~/i220b/work/lab13/file-char-count$ wls
bash: wls: command not found
qxiong1@remote00:~/i220b/work/lab13/file-char-count$ ls
file-char-count  file-char-count.c  Makefile
qxiong1@remote00:~/i220b/work/lab13/file-char-count$ ./file-char-count xxx
cannot read xxx: No such file or directory
qxiong1@remote00:~/i220b/work/lab13/file-char-count$ ./file-char-count xxx[K[K[Khello
cannot read hello: No such file or directory
qxiong1@remote00:~/i220b/work/lab13/file-char-count$ ./file-char-count hello[K[K[K[K[K123
cannot read 123: No such file or directory
qxiong1@remote00:~/i220b/work/lab13/file-char-count$ exit
exit

Script done on 2019-11-14 15:20:56-05:00 [COMMAND_EXIT_CODE="1"]
